zqk: svb
jjc: yvk aoc jyv
qbm: rue tcj
vby: rvp pkd
evb: eul
rjk: goi jla
zfo: usi
mle: yls jix
zng: irm zsm
vvf: hhu
mks: yui ilo nob
ner: ihv mpi bma lls
bss: qxt xmf mot pik
ozs: you
pur: dje
jix: xbo
wfl: asm jxn
qgn: wfl bpx ijg
nne: you svb
jga: jqz
fqs: out
vlu: skf
gfy: avr omx ner
zgb: snc wkt vui
snc: tsn xrb rpc
asm: gwj
hhu: jnp zke
syg: bbd pxo fbf
zsm: xuu rtv tcj
wqn: hxq luy
bpa: nhv tej
pst: usi xac
kud: gch xxc vby
dmo: tcj
pkd: aoc jyv jqr
fsm: cab szm bvg ufi
ufi: lje qgi dcu ecb gkd oxi dvb ing vjx iiv uqa hnc tsv fuj qza fju yby swt pvm npm
mti: nis xgu gbm
jue: uae
jki: out
zdm: htt asp
aym: kwo zlh jun tkd
fju: yls
iin: jqr yvk
nae: vby knr
tkd: aoc yvk
dio: ksz tpg eyk vhc btl
gkd: vlu
pme: lvq fta
alg: rzk qcf kjq
jxn: dje tnh
rnv: hig
iwr: hiy cfh jfb szr
yop: aiu mrt
tju: fiw tej nhv dlf
hxq: jun zlh tkd
hho: you
quf: kvz bvg cab ufi
rue: kun ghk ykr qpn qgn rak bpa zwv znk hqb mmg kpm jdn eme swj
fvd: ven rnd zza tby
bud: cmo
tel: nof lni
fmm: cgq
jnr: hes wbb
zaz: xac
tfq: bvg kvz cab szm ufi
pvl: bbd pxo eya fbf
idy: cqp
tau: cxg upw aml
pko: tfz pmp dbp
lfn: jyv yvk aoc
kan: jqr jyv yvk aoc
cqp: odh quk
vqb: szm
ufe: bpx
zfl: nwb
bup: yjx
jze: ebx
zjf: jom
hlc: qkl
jyv: wso bxe qaa jmb ene bss ygt gfy mhd mgh idy sbj zwl
swj: loq zep
bzn: amu nii che xah nne
llj: ugo uuk zsm
sxf: ztc rnv tel
dub: cjc ikl vhy vvm huo mmr gcv grp ecf khc kks xat
sbq: out
dpr: nwb heq
xif: quu
qgv: skq zdm cxc
czc: syf tbb kxq upq fqs
xxc: pkd wpv rvp kan
rpc: out
rul: utf
hue: kjp zjf cjc mmr bwx vvm huo ecf mti khc tzt grp woa hwo dab xat
aml: vjj czc
fng: ugn hhu fta
cjc: jom jnr
lbc: wxc
rak: xgm mks
grp: lbc qqk blc
amu: svb ecy you
ndl: rtv xuu
glg: ege ojd eqc
esh: jqr yvk
hts: dio gow
wua: ecy
zke: tnh
aiu: fjn
cpw: rue rtv xuu tcj
dkw: eiz
luy: tkd glt kwo
ihv: ndl gvj vnc
qim: zep
cqe: kvz szm
ven: tnh gwj
wvl: skq
xgm: ilo
qap: dbp bzn
mds: tpw cgs lyk dkw
opb: vlu nnz pza wqn
cue: flr szr jfb cfh hiy
hqd: qdb tfq uwa
svb: mng sux gvk vxi dys rjc dgd cwg rrk egw wfh twy bup voe
ltp: vzn rob
blc: crh wxc jla glg
htt: you ecy
bpw: hba oha wjc jga
pza: hxq aym
eiz: cab szm ufi
ggh: asm jxn
vum: mky
ffj: zpr tau
nis: vqb ogf
fwu: szx aiu fln
bmv: bud ijg ggh
nob: uvy qxp dxe
beq: szm bvg ufi
jkx: qgv dac utw dhr
cxc: asp nyv htt
dho: ecy you
gpn: anh vxr fvd
qqk: goi jla
lls: gvj
dcu: kud nae jii qgy
jom: sjh
kjp: rjk joh blc
xlr: efm mds
ogf: kvz bvg cab
uqa: jii nae qgy
rzk: iin kmo
szx: fjn
gmx: out
wyp: jjc ebx
nof: bpq hku gsi
mhd: rob vzn
goi: irb eqc ojd
vtm: ner
paf: vew
ebf: dhr utw dac wvl qgv
sbs: ecy
zep: vvf lep pme hkz
tar: bvg
cwr: kxq fqs upq
ois: wqd jue tpy mpy
dlf: lxr sec hqe
nmo: pjp eda sxf
jdn: zep loq
che: you
hgx: qua
lje: mce ckd ihm
bvn: zng mum
qsi: nak
zza: gwj dje
vxr: jal rnd zza
lep: ugn fta
rvp: jqr yvk
pyl: axy pvl ttq syg
odh: xuu quu rtv tcj
dhz: qgy nae
wpv: yvk aoc jqr
dxe: pur
hic: mmr gcv dkd kks vvm dab hwo xat huo ecf tzt khc zjf woa ikl
ksz: you ecy svb
voe: lgv fmm
txt: ksz tpg btl eyk
vhy: rjk lbc qqk joh blc
quk: xuu
ygt: avr omx ner
fln: hby dro
sjh: vip ult sbu tar
egw: gxq ois
ktn: ufi cab szm kvz
owb: xuu rue tcj
qom: out
mpy: dkr bbv uae
mpi: jhc gvj vnc
qma: bgp
jqi: gvj jhc ndl
pxo: dps xif frj cpw
gju: lep vvf fng hkz pme
omw: hes
fft: ebx ipe jjc
utf: rxz hho sqy
lgi: iio nwi
wjc: eim
klz: jjc ebx
sbu: bvg cab ufi
glt: jyv jqr yvk
bgp: dja lfn
gxq: mpy jue wqd
rxz: svb you
mos: okx
vnc: rtv tcj
zlh: yvk jyv jqr
dvb: jze klz
qxt: pat dtx
wqf: eyo okr
syf: out
loq: hkz fng
gvx: upw uny
gch: kan wpv pkd
okr: dje tnh gwj
qza: wqn iwn nnz vlu
bxe: pyl psz vzn rob
wmc: ufi bvg kvz szm cab
gbm: ogf rke vkv
xsx: zgb pun
fdx: ebf raa jkx ytj
mdx: gvx zpr
kun: xgm eqy
wbb: vip ult ktn
jlj: kcx pko qap ane
hoj: odh qbm quk
tpw: beq xqx eiz cqe
yjx: mpy tpy
sji: anh xjw fvd vxr
bma: ndl
eyo: gwj dje tnh
art: tel
vpg: gwj tnh dje
tbb: out
lob: usi rul
hba: eim jqz
src: xxc gch
jpd: qdb cun
xbo: kjq gvn qcf
eqc: ufi bvg cab
mmg: vum lud sqm yam
rkm: ujm hig nof
fjn: jqr jyv yvk aoc
bbv: zxd
fiw: lxr sec
vxi: fmm
tej: lxr xqi
upw: czc vjj
xgu: vkv rke vqb
oha: wxu eim jqz
hqb: vfa gpn
hzx: mky zkp
wtx: szm kvz bvg ufi
zkp: okr
jun: yvk jyv jqr
kxq: out
kmo: yvk jqr
ujm: hku plf gsi bpq gpb
eyk: ecy
bbd: cpw dps
ytj: wvl dac
mot: hlc mos
wxu: qom sbq gmx wng
xds: idn mot qxt xmf
dkd: nis vuf gbm xgu
qpx: you ecy
uwa: bvg kvz szm ufi
nwi: out
xqx: szm cab bvg kvz
khc: xvw
qhy: lfn esh
vvm: joh lbc qqk rjk
xrb: out
nwb: zgb pun
izj: ztc rkm
szr: ozs zqk
ikl: jom
syu: fln aiu szx mrt
cun: ufi szm cab
ult: szm cab kvz bvg
uxi: mrt fln aiu
idn: pat mos dtx
hsy: eda sxf art
xmf: nrp dtx hlc mos
jla: irb eqc ojd ege wmc
qgy: xxc
efm: uvp dkw
yro: ytj jkx raa ebf
uae: lsx
yam: mky zkp wqf
tsv: ihm mce qma
vkv: ufi bvg kvz szm
jqz: qom vja wng
amc: gvx
cmo: dje
anh: tby
rjc: lgv
irm: quu
kcx: pmp tfz
mky: quq eyo
jlx: out
utw: zdm cxc
thc: fdw
mce: bgp qhy
xjw: zza tby ven jal
okx: rtv quu xuu tcj
ftk: sum dkd mmr huo kks bwx dab khc mti woa ikl grp
oeo: rtv
twy: mdx uzf amc
miy: dja lfn
nak: rtv quu tcj
ege: szm kvz ufi
heq: lwc pun
eme: gju zep loq
woa: jnr
wrh: hee syv qua
gsi: jki jlx
nii: svb
zwl: idn pik qxt xmf
zpr: aml upw
jii: knr
npm: yop uxi
hee: wtx fsm fou
zxd: nwi vsd iio
ebx: jqr jyv aoc yvk
kjq: gwz iws iin
hby: jyv jqr aoc yvk
xah: ecy svb
fuj: fwu yop epi
zmv: ecy svb
sum: jpd xvw
mrt: fjn hby
usi: cvl bdq utf
cyk: xac rul
ryt: ogf vkv rke
ing: nae kud
wgk: mce ihm
jal: dje gwj
jte: iwr
mgh: hoj qsi eul
jmb: llj
ykr: vfa sji gpn
pvm: iwn
ane: dbp bzn tfz
eng: sst pko
dtm: ikl zjf cjc huo bwx vvm dkd mmr woa grp khc tzt ecf mti xat hwo dab kks sum
tcc: qcf gvn
eda: rnv
dgd: ffj amc mdx
joh: crh goi jla glg
qua: fou fsm
tzt: hqd jpd
fap: oha wjc jga
uny: cwr vjj
dha: iwr vew mlg cue
fdw: uvp tpw
qgi: wqn pza iwn vlu
dab: thc szc xlr
tcj: bmv ykr ghk kun arz bpa rak qpn znk qim eme swj jdn tju kpm ufe hqb lwl mmg
ktu: jze
nhv: lxr sec
kwo: aoc jqr
svr: ftk dtm dub hic hue
lgv: jay bpw fap
ckd: qhy
pun: wkt
plf: jki qwo
szm: pvm dhz npm vnr qza yby fuj uqa iiv ing ntj dcu ecb lje qgi
rnd: tnh
qxp: pur zzf
ntj: klz
pat: qkl dmo
ecy: gvk vxi lka mng sux egw unc twy bup voe rjc hsy dgd cwg nmo
ijy: jay
huo: thc szc
qkl: quu rue tcj
gow: vhc eyk btl ksz tpg
iws: aoc yvk jqr
rbl: heq nwb npl xsx
nqz: qap sst
kks: hgx zmr wrh
lyk: beq yfd xqx cqe
tnh: cyk ica paf zfo ypd eng jte lob qee fdx dha
wxc: wmc ege irb eqc
tpy: dkr
dtx: okx qkl
syv: fou wtx
wqd: uae
sux: zfl rbl orl dpr
zmr: syv
bdq: dho sqy hho rxz
net: rxz dho sbs
yui: fcu dxe uvy
epi: fln
rke: ufi bvg cab
arz: eqy xgm
sec: gwj dje
dhr: zdm skq
ghk: fiw
sst: tfz pmp dbp
flr: zqk wua qpx
lvq: zke jnp
dbp: amu nii nne
ica: gow txt
you: lka vqc gpc vxi dys hsy rjc tcb rrk nmo wfh egw
cgq: oha
vnr: yop epi syu uxi fwu
yls: tcc
knr: pkd wpv
gvk: lgv fmm ijy
ugn: jnp
dys: rbl orl dpr
oxi: wyp jze
qnz: eyo quq
lwl: yam sqm lud vum
mlg: flr szr jfb cfh hiy
iiv: sce
btl: you svb ecy
mng: zfl
vui: rpc tsn xrb
vjj: fqs syf
ijg: asm
juw: gow
vjx: yop syu
mnj: pyl fdq
qcf: iin
ipe: aoc yvk jqr jyv
kvz: wgk tsv iiv npm pvm dhz swt yby fju vnr qza ecb dcu ntj qgi lje ktu dvb gkd oxi
wfh: yjx ois gxq
qee: cue
tpg: you svb
vfa: xjw vxr
yby: jix sce
lxr: tnh
gwz: yvk jqr jyv
fbf: oeo xif cpw
ttq: bbd pxo
vqc: mdx amc ffj
vja: out
aoc: wso ygt ltp bvn qaa bxe idy evb mgh
hnc: src kud jii nae
nyv: you svb
wng: out
quu: tju jdn eme swj mmg lwl hqb kpm ufe znk qim qpn qgn ykr arz
irb: ufi kvz bvg szm cab
ypd: mlg
lms: tnh dje gwj
hoz: tcj xuu quu rue rtv
zbn: avr
oeh: wvl
sqy: you ecy
yfd: ufi cab bvg
lni: bpq hku gsi
cvl: sbs dho sqy hho
bpx: cmo jxn
hwo: gbm xgu nis ryt
npl: lwc pun zgb
iwn: aym luy skf hxq
fou: ufi szm bvg kvz
dac: zdm skq cxc
hig: hku plf
dja: yvk jyv jqr
ubs: pik mot xmf qxt
iio: out
lka: ois gxq
gcv: xlr
qpn: sqm yam vum hzx lud
qwo: out
qaa: qsi hoj
tfz: xah amu
vip: ufi szm cab kvz
hes: sbu ult vip ktn tar
ecb: jix yls
zwv: sji vfa
eim: qom vja
kpm: bud wfl bpx
lud: qnz mky wqf zkp
cwg: izj art
xuu: ufe kpm qgn lwl eme swj bpa kun qim bmv ghk znk
lsx: nwi vsd
psz: syg axy pvl
frj: tcj quu
gpb: jki
wkt: rpc xrb
jnp: gwj tnh dje
asp: svb ecy
fta: zke lms
xac: cvl bdq net utf
yvk: mhd gfy ubs ygt bss xds zbn mnj bvn sbj idy evb ltp vtm jmb bxe qaa
jfb: wua ozs
xqi: dje
uuk: tcj rtv rue
hiy: ozs qpx
unc: ois
nrp: dmo okx
swt: fft
vsd: out
qdb: cab szm kvz bvg
gvj: tcj rue quu
ojd: bvg cab ufi
vew: flr cfh
skq: nyv zmv htt
vzn: ttq axy pvl
pjp: ztc rkm
dro: yvk aoc
tcb: uzf amc
nnz: skf aym
cgs: xqx eiz cqe beq
ecf: hgx zmr
hku: qwo
gvn: gwz kmo
cxg: cwr vjj czc
ihm: miy
fdq: syg axy
tby: tnh
dje: dha pst fdx qee hts nqz jte guy jvk lob yro zaz ypd zfo jlj juw
sce: alg tcc
ene: pyl
bpq: jlx jki
jay: jga wjc oha
vuf: quf vkv vqb
uzf: gvx zpr
xat: xlr szc
ugo: tcj rtv quu xuu
znk: gju
mmr: omw jom
ztc: nof hig
skf: kwo glt
dps: quu xuu rtv rue
avr: bma jqi mpi
jvk: gow dio
zzf: tnh
sqm: wqf qnz
dkr: lsx lgi zxd
gpc: uzf
vhc: ecy svb you
axy: eya pxo fbf
tsn: out
hkz: ugn
uvp: xqx cqe eiz beq yfd
xvw: qdb uwa
guy: oeh raa
gwj: ica paf jlj juw ypd eng yro jvk guy nqz jte qee pst dha fdx
orl: xsx nwb npl heq
bvg: tsv qgi ktu dcu swt yby qza mle
omx: jqi lls bma
upq: out
raa: dhr utw
pik: pat hlc dtx
crh: irb ojd wmc
bwx: zmr wrh
uvy: zzf vpg
sbj: mum llj zng
quq: dje gwj
jhc: xuu rue rtv tcj
hkg: cgs tpw lyk uvp
mum: irm uuk owb ugo
eya: xif dps cpw
ilo: qxp dxe uvy
pmp: xah che
eul: odh hoz qbm
fcu: zzf
lwc: vui
rtv: znk ghk ykr arz jdn tju bpa eme swj qpn hqb mmg kpm qgn
jqr: zwl mnj zbn xds bvn idy gfy ubs bss vtm ene qaa ltp
cab: hnc oxi fju opb ing fuj
rrk: orl
wso: hoj cqp eul
cfh: zqk qpx ozs
hqe: gwj
eqy: yui ilo
rob: pvl
szc: fdw efm hkg